######################=========###########################################
#.....................=========..........................................#
#......................=======...................^^..^^^^................#
#.............^^^.......=======..................^^^...^^^...............#
#......^^^...^....^^^.....====...........^^^.^^.......^^^...^............#
#........^^^...^^...^.....====......^^^^.....^^^.........^...^...........#
#.......^^^^^^^^..........====.........^^^^...........^^^^^..............#
#........^^^^^^............===.....^^^^.........................^^^......#
#.........^^^^^.............===.......^^^...........^^^...^^.............#
#........^^^^^................===.........^^^^....^^......^^^^...........#
#.........^^^..................===......^^^^^....^^^^^.......^^..........#
#.........^^............^^^......==.........^^^....^^^^^.................#
#................^^^^^......^^^...==.................^^^.................#
#..................^^^......................^^^^^.....^^^................#
#..........^^^^^............................^^^.....^^^^^................#
#...................................====................^^...............#
#.................^^^^.............=========.................^^^^^.......#
#.......^^^^...^^...^^^^..........============..............^^^^^^^......#
#......^^^^^...^^^....^^..........==============..............^^^...^^^..#
#.....^^^....^^..........^^^.......==============....^^^^^....^^^^^......#
#............^^^^......^^^..........============.........................#
#.................^^.......^^^.......==========..................^^^^^...#
#.............^^^^....^..................=======..........^^^^......^^...#
#...........^^^^..........^^^^^............=====.............^^^^^.......#
#..........................................====..........................#
#..........^^................^^^^........=====.......^^..................#
#.................^^...^..................=====...........^^^............#
#........^^^^^..........^^^^^^^^............====............^^^^^........#
############################################=====#########################
